RGBGBGBRRGR
BRGR_GRGBRB
G_BG_R_RGBG
BR__GBRGBRB
G_BGBGBRGBG
