_BBRBGGB_G_
RBBGBBR__RR
RB__GBG__RR
RBG__GG_RRR
BR__RBGBRGB
